0
46
0
24
00000000000000000000000000000000000000000000000
00000000000000000000000000000000000000000000000
01111111000000000000000000000000000000000011110
00000000000000000000000000000000000000000000000
00000000000000000000000000000000000000000000000
00000000000000000000000000000000000000000000000
00000000000000000000000000000000000000000000000
00000000000000000000000000000000000000000000000
00000000000000000000000000000000000000000000000
00000000000000000000000000000000000000000000000
00000000000000000000000000000000011000000000000
00000000000000000000000000111111100000000000000
00000000000010000000000000111111100000000000000
00000000000000000000000000111111100000000000000
00000000000000100000000000111111100000000000000
00000000000000000000000000111111100000000000000
00000000000000000000000000111111100000000000000
00000000000000000000000000111111100000000000000
00000000000000000000000000000000000000000000000
00000000000000000000000000000000000000000000000
00000000000000000000000000000000000000000000000
00000000000000000000000000000000000000000000000
00000000000000000000000000000000000000000000000
00000000000000000000000000000000000000000000000
00000000000000000000000000000000000000000000000
